111111111111111111111111
1P0000000000000000000001
1000000000000C00000000C1
100111000000000000011111
100000111100000000000001
100000C00010000000000001
1000000000111100000C0001
100000C00111111111100001
10000000010E000011100001
1000C0000100000000100001
100000000111000000100001
1000000000000000001C0001
10000CCCC000000000000001
111111111111111111111111