111111111111111
11PC00000000C01
1000111011111E1
100000000000101
100011000000001
110111C00001111
10000000101C0C1
100101001000001
111111111111111