111111111111111
110000000000C01
100011101111001
100000000000101
100011000000001
110111C00001111
10000P0010100C1
100101001000001
100101001000001
100101001000001
100101001000001
10010100100E001
100101001000001
111111111111111