1111111111111111111111111111111111
1E0000000000000C00001C000000000001
1010010100100000101001100000111111
1010010010101V10001001111011111011
100000000C00C00000P0000000000000C1
1111111111111111111111111111111111
