111111111111111111111111111111111111111111111111
111111111111111111111111111111111111111111111111
1P0000000000011111011001000000000111110110000101
100000001010010000000010010101001000000110010001
100000001C10010000011100000101C10010000011000011
100000000000000000000000000000000000000000000001
101100000000000000000000000000000000000000000001
100000000000000000000000000000000000000000000001
100011000CC0000100011000000000CC0000100011000111
10000C000000000100011000100000000100011000C10001
111000C0000C10000000000001C010C0000000000000C001
100000000000000000000000001110001101000110000111
1011111C0000C100000000000000000011111C000C101001
10000C10110000000000000000000000000C0011111100C1
1000000000000000000000000000000000000000000100E1
100100000000011111011001000000000111110110100111
100100101010010000011001001010000100000110000001
100000101C10010000011100000101C00010000011000001
10000C1111100101000110000C111110010100011000C101
101111111110000000000000000000000000000000000101
100000000000000000000000000000000000000000000001
100000000000000111111111111110000000000000000001
111111111111111111111111111111111111111111111111
